1;1;1;1;1;1;1;1;1;1;1;1;1;1;1;1;1;1
1;7;0;0;0;2,2,11;0;0;0;0;0;0;0;0;1;1;1;1
1;1;0;1;1;1;1;1;2,4,10,11;1;1;1;1;2,2,12;1;1;1;1
1;1;0;1;1;1;1;1;3,1,10,12,13;1;1;0;0;0;0;0;1;1
1;1;0;3,2;1;1;1;1;2,10;1;1;3,7,9;1;1;1;0;1;1
1;1;0;1;1;1;1;1;0;1;1;2,9;1;1;1;0;1;1
1;1;2,2,4;1;1;1;1;1;0;1;1;0;1;5,1;1;0;1;1
1;1;0;1;1;1;1;1;0;1;1;0;1;2,1;1;0;1;1
1;1;0;0;2,6,13;0;0;0;0;0;0;0;0;0;0;2,7;1;1
1;1;0;1;0;1;1;1;0;1;1;1;1;1;1;0;1;1
1;1;0;1;3,7,11,12;1;1;1;2,7,6,13;1;1;1;1;1;1;0;1;1
1;1;0;1;1;1;1;1;3,6;1;1;1;6;1;1;0;1;1
1;1;0;1;1;1;1;1;2,5,6,13;1;1;1;4,1;1;1;0;1;1
1;1;0;1;1;1;1;1;0;1;1;1;0;0;0;0;1;1
1;1;0;0;0;0;0;0;0;1;1;1;1;1;1;1;1;1
1;1;1;1;1;1;1;1;1;1;1;1;1;1;1;1;1;1
