1;1;1;1;1;1;1;1;1;1;1;1;1;1;1;1;1;1
1;1;1;1;1;1;1;1;5,1;1;1;1;1;1;1;1;1;1
1;1;1;1;1;1;1;1;2,5;1;1;1;1;1;1;1;1;1
1;1;1;1;1;1;1;1;2,4;1;1;1;1;1;1;1;1;1
1;1;1;1;1;1;1;1;2,3;1;1;1;1;1;1;1;1;1
1;1;1;1;1;1;1;1;2,2;1;1;1;1;1;1;1;1;1
1;1;1;1;1;1;1;1;2,1;1;1;1;1;1;1;1;1;1
1;3,1,3,2;3,2,5;3,1,2,5;3,1,3,4;3,3,5;3,2,4;3,1,2,4;3,4,5;3,1,3;3,1,2,5;3,2,3,5;3,2,3,4;3,3,4,5;3,2,5;3,1,2,3;3,1,2,4;1
1;3,2,4,5;3,1,3,5;3,1,2,4;3,2,4;3,2,5;3,1,3,4;3,2,5;3,2,3,4;3,2,3,5;3,1,3,4;3,1,4;3,2,3,5;3,2,5;3,2,4;3,2,3,5;3,3,4;1
1;3,2,3;3,1,5;3,3,4,5;3,1,2;3,1,4,5;3,1,3;3,2,4;3,2,5;3,3,5;3,2,4;3,1,3,5;3,4,2;3,1,3,4;3,2,4,5;3,1,5;3,2,3,5;1
1;3,4,1;3,2,3,4;3,1,3,5;3,2,3;3,2,4,5;3,3,5;3,1,2,5;3,3,4;3,4,5;3,1,3,4;3,2,3;3,1,3,4;3,2,5;3,2,3,5;3,3,4;3,1,2,4;1
1;3,1,3,5;3,4,5;3,2,4;3,2,3;3,3,4,5;3,1,5;3,1,3,4;3,1,2;3,3,5;3,4,5;3,1,2,5;3,1,3,4;3,1,2;3,1,2,3;3,1,4;3,2,4;1
1;0;0;0;0;0;0;0;7;0;0;0;0;0;0;0;0;1
1;1;1;1;1;1;1;1;4,1;1;1;1;1;1;1;1;1;1
1;1;1;1;1;1;1;1;6;1;1;1;1;1;1;1;1;1
1;1;1;1;1;1;1;1;1;1;1;1;1;1;1;1;1;1
