1;1;1;1;1;1;1;1;1;1;1;1;1;1;1;1
1;1;1;1;1;1;1;1;1;1;1;1;1;1;1;1
1;1;1;1;1;1;6;1;1;1;1;1;1;1;1;1
1;1;1;1;1;1;4,2;1;1;1;1;1;1;1;1;1
1;1;3,3;1;1;0;1;1;1;1;3,4;1;1;1;1;1
1;1;0;2,2;0;0;0;0;0;2,3;0;1;1;1;1;1
1;1;1;1;1;1;0;3,2;1;1;1;1;1;1;1;1
1;1;1;1;1;1;4,1;1;1;1;1;1;5,2;1;1;1
1;1;1;1;1;1;0;1;1;1;1;1;1;0;1;1
1;1;1;1;1;1;0;1;1;1;1;1;1;2,4;1;1
1;1;1;1;0;0;0;0;2,2;0;2,3;0;1;1;1;1
1;1;1;1;0;1;0;1;1;1;1;1;1;1;1;1
1;1;1;1;0;1;5,1;1;1;1;1;1;1;1;1;1
1;1;1;1;7;1;1;1;1;1;1;1;1;1;1;1
1;1;1;1;1;1;1;1;1;1;1;1;1;1;1;1
1;1;1;1;1;1;1;1;1;1;1;1;1;1;1;1
